NO textures/home/window.xpm
SO textures/home/library.xpm
WE textures/home/wall.xpm
EA textures/home/lamp.xpm

F 132,32,53
C 244,101,45

111111111111111111111
101000001000000000001
101010101011111110001   1111111
100010100010000010001   1000001
111110101111101011101   1000001
100000101000101000001   1111111
101111101011101111111
101000001010100000101
101011111010111110101
101010001010100010101
101110101010101010101
100000101010001010001
111111101011111011101
100000101000100010001
101110101110101110111
101000100000100010101
101011111111111010101
1N0010000000000010001
101010111011111111101
101000001000000000001
111111111111111111111

