NO textures/test/north.xpm
SO textures/test/south.xpm
WE textures/test/west.xpm
EA textures/test/east.xpm

F 132,32,53
C 6,32,89

  1
 101             11111111111
10001        111111100000011
10001        100000000000001
10001111111111000111111111111111
100000000000000011
10000000000000111
100011111111110001
10001        111111111111111111
10001
1N001
1001
 101
  1

