NO textures/test/north.xpm
SO textures/test/south.xpm
WE textures/test/west.xpm
EA textures/test/east.xpm

F 0,0,0
C 0,0,0

  1
 101             11111111111
10001        111111100000011
10001        100000000000001
10001111111111000111111111111111
100000000000000001
100011111111110001
10001        1111111111111111111
10001
1N001
1001
 101
  1111

