NO textures/test/north.xpm
SO textures/test/south.xpm
WE textures/test/west.xpm
EA textures/test/east.xpm

F 220,100,0
C 225,30,0

        1111111111111111111111111
        1000000000110000000000001
        1101100000111000000000001
111111111100000000000000000000111
1111111011000001110000000000001111
100000000011000001110111111111111111
111101111111110111000000111111111111
11110111111111011101010010111
11000000110101011100000010001
10000000000000001100000010001
10000000000000001101010010001
11000001110101011111011000N01
11110111 1110101 101111010001
11111111 1111111 111111111111