NO textures/creepy/mirror.xpm
SO textures/home/window.xpm
WE textures/dungeon/gate.xpm
EA textures/test/east.xpm

F 220,100,0
C 225,30,0

        1111111111111111111111111
        1000000000110000000000001
        1101100000111000000000001
111111111100000000000000000000001
1111111011000001110000000111111111
1000000000110000011101111111111111
1111011111111101110000001111111111
11110111111111011101010010111111   
11000000110101011100000010001111
10000000000000001100000010001111
10000000000000001101010010001111
11000001110101010111011000S01111
11110111 11101011101111110001111
11111111 1111111 111111 11111111
                       