NO textures/test/east.xpm
SO textures/test/east.xpm
WE textures/test/east.xpm
EA textures/test/east.xpm

F 164,169,20
C 153,204,144

111111111111111111111111111111111111111111111111111
100100000000000000000001010111110000000000000000001
100000000001110000000000000000001000000000000001001
101111110000000000000000000000000000000000000001101
111100000000000000000000000000000000000000000000001
1000S1000000111000000000000000000000000000000111001
100000000000111000000000000000000000000000000111001
100011000000111000000000000000000000000000000111001
100001000000111000000000000000000000000000000111001
100001000000111000000000000000000000000000000111001
100001000000111000000000000000000000000000000111001
100001000000111000000000000000000000000000000111001
100001000000000000000000000000000000000000000111001
100001000000000000000000000000000000000000000111001
100001000000000000000000000000000000000000000111001
100001000000000000000000000000000000000000000111001
100001000000000000000000000000000000000000000111001
100001000000000000000000000000000000000000000111001
100001000000000000000000000000000000000000000111001
100001000000000000000000000000000000000000000111001
100001000000000000000000000000000000000000000111001
100001000000111000000000000000000000000000000111001
100001000000111000000000000000000000000000000111001
100001000000111000000000000000000000000000000111001
100001000000111000000000000000000000000000000111001
100001000000111000000000000000000000000000000111001
100001000000111000000000000000000000000000000111001
100001000000000000000000000000000000000000000111001
100001000000000000000000000000000000000000000111001
100001000000000000000000000000000000000000000111001
100001000000000000000000000000000000000000000111001
100001000000000000000000000000000000000000000111001
100001000000000000000000000000000000000000000111001
100001000000000000000000000000000000000000000111001
100001000000000000000000000000000000000000000111001
100001000000000000000000000000000000000000000111001
100001000000111000000000000000000000000000000111001
100001000000111000000000000000000000000000000111001
100001000000111000000000000000000000000000000111001
100001000000111000000000000000000000000000000111001
100001000000111000000000000000000000000000000111001
100001000000111000000000000000000000000000000111001
100001000000000000000000000000000000000000000111001
100001000000000000000000000000000000000000000111001
100001000000000000000000000000000000000000000111001
100001000000000000000000000000000000000000000111001
100001000000000000000000000000000000000000000111001
100001000000000000000000000000000000000000000111001
100001000000000000000000000000000000000000000111001
100001000000000000000000000000000000000000000111001
100001000000000000000000000000000000000000000111001
100001000000111000000000000000000000000000000111001
100001000000111000000000000000000000000000000111001
100001000000111000000000000000000000000000000111001
100001000000111000000000000000000000000000000111001
100001000000111000000000000000000000000000000111001
100001000000111000000000000000000000000000000111001
100001000000000000000000000000000000000000000111001
100001000000000000000000000000000000000000000111001
100001000000000000000000000000000000000000000111001
100001000000000000000000000000000000000000000111001
100001000000000000000000000000000000000000000111001
100001000000000000000000000000000000000000000111001
100001000000000000000000000000000000000000000111001
100001000000000000000000000000000000000000000111001
100001000000000000000000000000000000000000000111001
100001000000111000000000000000000000000000000111001
100001000000111000000000000000000000000000000111001
100001000000111000000000000000000000000000000111001
100001000000111000000000000000000000000000000111001
100001000000111000000000000000000000000000000111001
100001000000111000000000000000000000000000000111001
100001000000000000000000000000000000000000000111001
100001000000000000000000000000000000000000000111001
100001000000000000000000000000000000000000000111001
100001000000000000000000000000000000000000000111001
100001000000000000000000000000000000000000000111001
100001000000000000000000000000000000000000000111001
100001000000000000000000000000000000000000000111001
100001000000000000000000000000000000000000000111001
100001000000000000000000000000000000000000000111001
100001000000111000000000000000000000000000000111001
100001000000111000000000000000000000000000000111001
100001000000111000000000000000000000000000000111001
100001000000111000000000000000000000000000000111001
100001000000111000000000000000000000000000000111001
100001000000111000000000000000000000000000000111001
100001000000000000000000000000000000000000000111001
100001000000000000000000000000000000000000000111001
100001000000000000000000000000000000000000000111001
100001000000000000000000000000000000000000000111001
100001000000000000000000000000000000000000000111001
100001000000000000000000000000000000000000000111001
100001000000000000000000000000000000000000000111001
100001000000000000000000000000000000000000000111001
100001000000000000000000000000000000000000000111001
100001000000111000000000000000000000000000000111001
100001000000111000000000000000000000000000000111001
100001000000111000000000000000000000000000000111001
100001000000111000000000000000000000000000000111001
100001000000111000000000000000000000000000000111001
100001000000111000000000000000000000000000000111001
100001000000000000000000000000000000000000000111001
100001000000000000000000000000000000000000000111001
100001000000000000000000000000000000000000000111001
100001000000000000000000000000000000000000000111001
100001000000000000000000000000000000000000000111001
100001000000000000000000000000000000000000000111001
100001000000000000000000000000000000000000000111001
100001000000000000000000000000000000000000000111001
100001000000000000000000000000000000000000000111001
100001000000111000000000000000000000000000000111001
100001000000111000000000000000000000000000000111001
100001000000111000000000000000000000000000000111001
100001000000111000000000000000000000000000000111001
100001000000111000000000000000000000000000000111001
100001000000111000000000000000000000000000000111001
100001000000000000000000000000000000000000000111001
100001000000000000000000000000000000000000000111001
100001000000000000000000000000000000000000000111001
100001000000000000000000000000000000000000000111001
100001000000000000000000000000000000000000000111001
100001000000000000000000000000000000000000000111001
100001000000000000000000000000000000000000000111001
100001000000000000000000000000000000000000000111001
100001000000000000000000000000000000000000000111001
100001000000111000000000000000000000000000000111001
100001000000111000000000000000000000000000000111001
100001000000111000000000000000000000000000000111001
100001000000111000000000000000000000000000000111001
100001000000111000000000000000000000000000000111001
100001000000111000000000000000000000000000000111001
100001000000000000000000000000000000000000000111001
100001000000000000000000000000000000000000000111001
100001000000000000000000000000000000000000000111001
100001000000000000000000000000000000000000000111001
100001000000000000000000000000000000000000000111001
100001000000000000000000000000000000000000000111001
100001000000000000000000000000000000000000000111001
100001000000000000000000000000000000000000000111001
100001000000000000000000000000000000000000000111001
100001000000111000000000000000000000000000000111001
100001000000111000000000000000000000000000000111001
100001000000111000000000000000000000000000000111001
100001000000111000000000000000000000000000000111001
100001000000111000000000000000000000000000000111001
100001000000111000000000000000000000000000000111001
100001000000000000000000000000000000000000000111001
100001000000000000000000000000000000000000000111001
100001000000000000000000000000000000000000000111001
100001000000000000000000000000000000000000000111001
100001000000000000000000000000000000000000000111001
100001000000000000000000000000000000000000000111001
100001000000000000000000000000000000000000000111001
100001000000000000000000000000000000000000000111001
100001000000000000000000000000000000000000000111001
100001000000111000000000000000000000000000000111001
100001000000111000000000000000000000000000000111001
100001000000111000000000000000000000000000000111001
100001000000111000000000000000000000000000000111001
100001000000111000000000000000000000000000000111001
100001000000111000000000000000000000000000000111001
100001000000000000000000000000000000000000000111001
100001000000000000000000000000000000000000000111001
100001000000000000000000000000000000000000000111001
100001000000000000000000000000000000000000000111001
100001000000000000000000000000000000000000000111001
100001000000000000000000000000000000000000000111001
100001000000000000000000000000000000000000000111001
100001000000000000000000000000000000000000000111001
100001000000000000000000000000000000000000000111001
100001000000111000000000000000000000000000000111001
100001000000111000000000000000000000000000000111001
100001000000111000000000000000000000000000000111001
100001000000111000000000000000000000000000000111001
100001000000111000000000000000000000000000000111001
100001000000111000000000000000000000000000000111001
100001000000000000000000000000000000000000000111001
100001000000000000000000000000000000000000000111001
100001000000000000000000000000000000000000000111001
100001000000000000000000000000000000000000000111001
100001000000000000000000000000000000000000000111001
100001000000000000000000000000000000000000000111001
100001000000000000000000000000000000000000000111001
100001000000000000000000000000000000000000000111001
100001000000000000000000000000000000000000000111001
100001000000111000000000000000000000000000000111001
100001000000111000000000000000000000000000000111001
100001000000111000000000000000000000000000000111001
100001000000111000000000000000000000000000000111001
100001000000111000000000000000000000000000000111001
100001000000111000000000000000000000000000000111001
100001000000000000000000000000000000000000000111001
100001000000000000000000000000000000000000000111001
100001000000000000000000000000000000000000000111001
100001000000000000000000000000000000000000000111001
100001000000000000000000000000000000000000000111001
100001000000000000000000000000000000000000000111001
100001000000000000000000000000000000000000000111001
100001000000000000000000000000000000000000000111001
100001000000000000000000000000000000000000000111001
100001000000111000000000000000000000000000000111001
100001000000111000000000000000000000000000000111001
100001000000111000000000000000000000000000000111001
100001000000111000000000000000000000000000000111001
100001000000111000000000000000000000000000000111001
100001000000111000000000000000000000000000000111001
100001000000000000000000000000000000000000000111001
100001000000000000000000000000000000000000000111001
100001000000000000000000000000000000000000000111001
100001000000000000000000000000000000000000000111001
100001000000000000000000000000000000000000000111001
100001000000000000000000000000000000000000000111001
100001000000000000000000000000000000000000000111001
100001000000000000000000000000000000000000000111001
100001000000000000000000000000000000000000000111001
100001000000111000000000000000000000000000000111001
100001000000111000000000000000000000000000000111001
100001000000111000000000000000000000000000000111001
100001000000111000000000000000000000000000000111001
100001000000111000000000000000000000000000000111001
100001000000111000000000000000000000000000000111001
100001000000000000000000000000000000000000000111001
100001000000000000000000000000000000000000000111001
100001000000000000000000000000000000000000000111001
100001000000000000000000000000000000000000000111001
100001000000000000000000000000000000000000000111001
100001000000000000000000000000000000000000000111001
100001000000000000000000000000000000000000000111001
100001000000000000000000000000000000000000000111001
100001000000000000000000000000000000000000000111001
100001000000111000000000000000000000000000000111001
100001000000111000000000000000000000000000000111001
100001000000111000000000000000000000000000000111001
100001000000111000000000000000000000000000000111001
100001000000111000000000000000000000000000000111001
100001000000111000000000000000000000000000000111001
100001000000000000000000000000000000000000000111001
100001000000000000000000000000000000000000000111001
100001000000000000000000000000000000000000000111001
100001000000000000000000000000000000000000000111001
100001000000000000000000000000000000000000000111001
100001000000000000000000000000000000000000000111001
100001000000000000000000000000000000000000000111001
100001000000000000000000000000000000000000000111001
100001000000000000000000000000000000000000000111001
100001000000111000000000000000000000000000000111001
100001000000111000000000000000000000000000000111001
100001000000111000000000000000000000000000000111001
100001000000111000000000000000000000000000000111001
100001000000111000000000000000000000000000000111001
100001000000111000000000000000000000000000000111001
100001000000000000000000000000000000000000000111001
100001000000000000000000000000000000000000000111001
100001000000000000000000000000000000000000000111001
100001000000000000000000000000000000000000000111001
100001000000000000000000000000000000000000000111001
100001000000000000000000000000000000000000000111001
100001000000000000000000000000000000000000000111001
100001000000000000000000000000000000000000000111001
100001000000000000000000000000000000000000000111001
100001000000111000000000000000000000000000000111001
100001000000111000000000000000000000000000000111001
100001000000111000000000000000000000000000000111001
100001000000111000000000000000000000000000000111001
100001000000111000000000000000000000000000000111001
100001000000111000000000000000000000000000000111001
100001000000000000000000000000000000000000000111001
100001000000000000000000000000000000000000000111001
100001000000000000000000000000000000000000000111001
100001000000000000000000000000000000000000000111001
100001000000000000000000000000000000000000000111001
100001000000000000000000000000000000000000000111001
100001000000000000000000000000000000000000000111001
100001000000000000000000000000000000000000000111001
100001000000000000000000000000000000000000000111001
100001000000111000000000000000000000000000000111001
100001000000111000000000000000000000000000000111001
100001000000111000000000000000000000000000000111001
100001000000111000000000000000000000000000000111001
100001000000111000000000000000000000000000000111001
100001000000111000000000000000000000000000000111001
100001000000000000000000000000000000000000000111001
100001000000000000000000000000000000000000000111001
100001000000000000000000000000000000000000000111001
100001000000000000000000000000000000000000000111001
100001000000000000000000000000000000000000000111001
100001000000000000000000000000000000000000000111001
100001000000000000000000000000000000000000000111001
100001000000000000000000000000000000000000000111001
100001000000000000000000000000000000000000000111001
100001000000111000000000000000000000000000000111001
100001000000111000000000000000000000000000000111001
100001000000111000000000000000000000000000000111001
100001000000111000000000000000000000000000000111001
100001000000111000000000000000000000000000000111001
100001000000111000000000000000000000000000000111001
100001000000000000000000000000000000000000000111001
100001000000000000000000000000000000000000000111001
100001000000000000000000000000000000000000000111001
100001000000000000000000000000000000000000000111001
100001000000000000000000000000000000000000000111001
100001000000000000000000000000000000000000000111001
100001000000000000000000000000000000000000000111001
100001000000000000000000000000000000000000000111001
100001000000000000000000000000000000000000000111001
100001000000111000000000000000000000000000000111001
100001000000111000000000000000000000000000000111001
100001000000111000000000000000000000000000000111001
100001000000111000000000000000000000000000000111001
100001000000111000000000000000000000000000000111001
100001000000111000000000000000000000000000000111001
100001000000000000000000000000000000000000000111001
100001000000000000000000000000000000000000000111001
100001000000000000000000000000000000000000000111001
100001000000000000000000000000000000000000000111001
100001000000000000000000000000000000000000000111001
100001000000000000000000000000000000000000000111001
100001000000000000000000000000000000000000000111001
100001000000000000000000000000000000000000000111001
100001000000000000000000000000000000000000000111001
100001000000111000000000000000000000000000000111001
100001000000111000000000000000000000000000000111001
100001000000111000000000000000000000000000000111001
100001000000111000000000000000000000000000000111001
100001000000111000000000000000000000000000000111001
100001000000111000000000000000000000000000000111001
100001000000000000000000000000000000000000000111001
100001000000000000000000000000000000000000000111001
100001000000000000000000000000000000000000000111001
100001000000000000000000000000000000000000000111001
100001000000000000000000000000000000000000000111001
100001000000000000000000000000000000000000000111001
100001000000000000000000000000000000000000000111001
100001000000000000000000000000000000000000000111001
100001000000000000000000000000000000000000000111001
100001000000111000000000000000000000000000000111001
100001000000111000000000000000000000000000000111001
100001000000111000000000000000000000000000000111001
100001000000111000000000000000000000000000000111001
100001000000111000000000000000000000000000000111001
100001000000111000000000000000000000000000000111001
100001000000000000000000000000000000000000000111001
100001000000000000000000000000000000000000000111001
100001000000000000000000000000000000000000000111001
100001000000000000000000000000000000000000000111001
100001000000000000000000000000000000000000000111001
100001000000000000000000000000000000000000000111001
100001000000000000000000000000000000000000000111001
100001000000000000000000000000000000000000000111001
100001000000000000000000000000000000000000000111001
100001000000111000000000000000000000000000000111001
100001000000111000000000000000000000000000000111001
100001000000111000000000000000000000000000000111001
100001000000111000000000000000000000000000000111001
100001000000111000000000000000000000000000000111001
100001000000111000000000000000000000000000000111001
100001000000000000000000000000000000000000000111001
100001000000000000000000000000000000000000000111001
100001000000000000000000000000000000000000000111001
100001000000000000000000000000000000000000000111001
100001000000000000000000000000000000000000000111001
100001000000000000000000000000000000000000000111001
100001000000000000000000000000000000000000000111001
100001000000000000000000000000000000000000000111001
100001000000000000000000000000000000000000000111001
100001000000111000000000000000000000000000000111001
100001000000111000000000000000000000000000000111001
100001000000111000000000000000000000000000000111001
100001000000111000000000000000000000000000000111001
100001000000111000000000000000000000000000000111001
100001000000111000000000000000000000000000000111001
100001000000000000000000000000000000000000000111001
100001000000000000000000000000000000000000000111001
100001000000000000000000000000000000000000000111001
100001000000000000000000000000000000000000000111001
100001000000000000000000000000000000000000000111001
100001000000000000000000000000000000000000000111001
100001000000000000000000000000000000000000000111001
100001000000000000000000000000000000000000000111001
100001000000000000000000000000000000000000000111001
111111111111111111111111111111111111111111111111111
 
 
 
